Behind the Mask|오직 너를 위해서 내일도 버티겠어
Cry For Me|You don't know me. L O V E or hatred
DALLA DALLA|남 신경 쓰고 살긴 아까워 하고 싶은 일 하기도 바빠
Dumb dumb|Dumb dumb dumb dumb dumb dumb (x3)
Empire|One day they will build empires for me
Fancy|꿈처럼 행복해도 돼
Feel Special|I feel loved. I feel so special
Firework|혈관이 터질 듯한 심장박동 like a supernova
Hell In Heaven|Take me to your paradise and kiss me in the blue moonlight
Hope Not|여전히 이곳에서 널 잊지 못해
How You Like That|그때쯤에 넌 날 끝내야 했어
I Can't Stop Me|Risky risky wiggi 위기 this is an emergency
Icy|Icy but i'm on fire
Lion|감히 또 누가 날 막고 또 누가 날 조종해
Love To Hate Me|You ain't worth my love, if you only love to hate me
Make Me Go|Don't need nobody else when it feels this good. Ain't nobody around, do it like you should
Not Shy|Not shy, not me (ITZYYYYYYYYYYYYYYYYYYYYY)
Oh My God|찢겨져 혼이 나간 채로 그저 어리버리 통제가 불가능해 설탕 뿌린 마약같이
Power Up|Ba banana ba banabana ba (x3)
Pretty Savage|Yeah, we some bitches you can't manage
Queen|누가 뭐라 해도 네 모습 그 자체로
RBB|*Dolphin screams*
Scorpion|そう 運命なんて言い訳して 縛ったりはしないで
Shadow|약해 보이긴 싫어 뻔한 눈물 따위 깊이 감출 테니
Sour Candy|I'm hard on the outside but if you give me time then I could make time for your love
Sunny Side Up!|Don't make my mind all scrambled up
Up No More|나는 더욱더 무너져만 가 나를 잃어가 버리는 게 두려워
Wannabe|It’s none of your business, I do my own business
Yes or Yes|Hey boy... look. I'm gonna make this simple for you, you got two choices: Yes or Yes!
You Never Know|You never know unless you walk in my shoes